e0 e0 c0 c0 c0 c0 e0 e0 e0 e0 e0 e0 c0 c0 c0 e0 e0 e0 e0 e0
e0 c0 e0 e0 e0 e0 e0 e0 e0 e0 e0 e0 e0 e0 e0 c0 c0 e0 e0 e0
c0 e0 e0 e0 e0 e0 e0 e0 e0 e0 e0 e0 e0 e0 e0 e0 e0 c0 e0 e0
c0 e0 e0 e0 e0 e0 e0 e0 e0 e0 e0 e0 e0 e0 e0 e0 e0 e0 c0 e0
c0 e0 e0 e0 e0 e0 e0 e0 e0 e0 e0 e0 e0 e0 e0 e0 e0 e0 e0 c0
c0 e0 e0 e0 e0 e0 c0 e0 e0 e0 e0 e0 e0 e0 e0 e0 e0 e0 e0 c0
c0 e0 e0 e0 e0 e0 e0 e0 e0 e0 e0 e0 e0 e0 e0 e0 e0 e0 e0 c0
e0 c0 e0 e0 e0 e0 e0 e0 e0 e0 e0 e0 c0 c0 e0 e0 e0 e0 e0 c0
e0 c0 e0 e0 e0 e0 e0 e0 e0 e0 e0 e0 c0 c0 e0 e0 e0 e0 e0 c0
e0 c0 e0 e0 e0 e0 e0 e0 e0 e0 t3716 t3716 e0 e0 e0 e0 e0 e0 e0 c0
e0 c0 e0 e0 e0 e0 e0 e0 e0 e0 e0 e0 e0 e0 e0 e0 e0 e0 c0 e0
e0 c0 e0 e0 e0 e0 e0 e0 c0 e0 e0 e0 e0 e0 e0 e0 e0 e0 c0 e0
e0 e0 c0 e0 e0 e0 e0 e0 e0 e0 e0 e0 e0 e0 e0 e0 e0 e0 c0 e0
e0 e0 c0 e0 e0 e0 e0 e0 e0 e0 e0 e0 e0 e0 e0 e0 e0 e0 c0 e0
e0 e0 e0 c0 e0 e0 e0 e0 e0 e0 e0 e0 e0 e0 e0 e0 e0 e0 c0 e0
e0 e0 e0 e0 c0 e0 e0 e0 e0 e0 e0 e0 e0 e0 e0 e0 e0 e0 c0 e0
e0 e0 e0 e0 c0 e0 e0 t3754 e0 e0 e0 e0 e0 e0 e0 e0 e0 e0 c0 e0
e0 e0 e0 e0 e0 c0 e0 e0 e0 e0 e0 e0 e0 e0 e0 e0 c0 c0 e0 e0
e0 e0 e0 e0 e0 e0 c0 c0 c0 c0 c0 c0 c0 c0 c0 c0 e0 e0 e0 e0
e0 e0 e0 e0 e0 e0 e0 e0 e0 e0 e0 e0 e0 e0 e0 e0 e0 e0 e0 e0
